
[Ett] 
1 1 1 1 1 1 1 1 1 1 1 1 0 1 1 1 
1 1 1 1 1 1 1 1 1 1 1 1 0 1 1 1 
0 0 0 0 0 0 1 0 0 0 0 0 0 0 1 1 
0 0 0 0 0 0 1 0 0 0 0 0 0 0 1 1 
0 0 0 0 0 0 1 0 0 1 1 1 1 1 1 1 
0 0 0 0 0 0 1 0 0 0 0 0 0 0 1 1 
0 0 0 0 0 0 1 1 1 1 1 1 0 0 1 1 
0 0 0 0 0 0 1 0 0 0 0 0 0 0 1 1 
0 0 0 0 0 0 1 0 0 0 0 0 0 0 1 1 
1 1 1 1 1 1 1 1 1 1 1 1 1 1 1 1 
1 1 1 1 1 1 1 1 1 1 1 1 1 1 1 1 
[Stop]


[Två]
1 1 1 1 0 1 1 1 1 1 1 1 1 1 1 1 
1 1 1 1 0 1 1 1 1 1 1 1 1 1 1 1 
1 1 0 0 0 1 0 0 0 0 1 0 0 1 0 0 
1 1 0 0 0 1 0 0 0 0 1 0 0 0 0 0 
1 1 0 0 1 1 0 1 0 0 1 0 0 1 0 0 
1 1 0 0 1 0 0 1 0 0 1 0 0 0 0 0 
1 1 0 0 1 0 0 1 0 0 1 0 0 1 0 0 
1 1 0 0 0 0 0 1 0 0 0 0 0 0 0 0 
1 1 0 0 0 0 0 1 0 0 0 0 0 1 0 0 
1 1 1 1 1 1 1 1 1 1 1 1 1 1 1 1 
1 1 1 1 1 1 1 1 1 1 1 1 1 1 1 1 [Stop]

[Tre]
1 1 1 1 1 1 1 1 1 1 1 1 1 1 1 1 
1 1 1 1 1 1 1 1 1 1 1 1 1 1 1 1 
0 0 0 0 0 0 0 0 0 0 0 0 0 0 1 1 
0 0 1 0 0 1 0 1 0 0 1 0 0 0 1 1 
0 0 1 0 0 1 0 0 0 0 0 0 0 0 1 1 
0 0 1 0 0 1 1 0 1 1 0 1 0 0 1 1 
0 0 0 0 0 1 0 0 0 0 0 1 0 0 1 1 
0 0 1 1 0 0 0 0 1 1 1 1 0 0 1 1 
0 0 0 1 0 0 0 0 0 0 0 0 0 0 1 1 
1 1 1 1 1 1 1 1 1 1 1 1 0 1 1 1 
1 1 1 1 1 1 1 1 1 1 1 1 0 1 1 1 [Stop]

[Fyra]
1 1 1 1 1 1 1 1 1 1 1 1 1 1 1 1 
1 0 0 0 1 0 0 0 0 0 0 0 1 1 1 1 
1 0 1 0 1 0 1 1 1 1 1 0 1 0 0 0 
1 0 1 0 0 0 1 0 0 0 0 0 1 0 0 0 
1 0 1 1 1 1 1 0 1 1 1 1 1 0 0 0 
1 0 0 0 0 1 0 0 0 1 0 0 0 0 0 0 
1 1 1 1 0 1 0 1 1 1 0 1 1 0 0 0 
1 0 0 0 0 1 0 1 0 0 0 1 1 0 0 0 
1 0 1 1 1 1 0 1 1 1 0 1 1 0 0 0 
1 0 0 0 0 1 0 0 0 0 0 1 1 1 1 1 
1 1 1 1 0 1 1 1 1 1 1 1 1 1 1 1 [Stop]